.........
.........
.........
.........
.........
.........
---

.#.   .#.
.##. .##.
 .##.##.
  .###.
---

.x.   .x.
.  . .  .
 .  .  .
  .w w.