........
........
........
........
........
........
........
........
---
#      #

   ##


   ##

#      #
---
#      #

   ##


   ##

#      #
---
#      #

   ##


   ##

#      #
---
........
..    ..
.  ..  .
. .... .
. .... . 
.  ..  .
..    ..
........
---


  
  x  
x    w
^   ^
     
^ w